word	lemma
's	de
Europese	Europees
Fransen	Frans
Fransje	Frans
Fransjes	Frans
Fransman	Frans
Gooise	Goois
Gordiaanse	Gordiaans
Kanaäns	Kanaän
Lands	Land
Olympische	Olympisch
Parlement	Parlement
Spelen	Spel
alle	al
aanstoots	aanstoot
andere	ander
banden	band
banken	bank
bate	baat
bedrage	bedrag
beentje	been
befje	bef
bekje	bek
belope	beloop
berge	berg
beste	best
beurze	beurs
bevoegde	bevoegd
bewijze	bewijs
boze	boos
brode	brood
burele	bureel
dage	dag
dagje	dag
dakje	dak
dele	deel
den	de
der	de
des	de
dezen	deze
dienste	dienste
diepste	diep
doeken	doek
domme	dom
duigen	duig
eenarmige	eenarmig
elfder	elfde
enen	één
enenmale	eenmaal
ere	eer
erogene	erogeen
faveure	faveur
gaten	gat
gedachten	gedachte
gehore	gehoor
gekke	gek
gemeste	gemest
gerechterlijke	gerechterlijk
gerieve	gerief
geroepen	roepen
geschrifte	geschrift
gespekte	gespekt
getale	getal
gevolge	gevolg
goede	goed
grave	graf
gronde	grond
groten	groot
gunste	gunst
haantje	haan
halve	half
haren	haar
harte	hart
hele	heel
hoofde	hoofd
hoogste	hoog
huize	huis
illigale	illigaal
jaargetijden	jaar_getij
jare	jaar
kantore	kantoor
keizers	keizer
kinderschoenen	kinderschoen
kleren	kleren
klote	kloot
knieën	knie
knoppen	knop
kopje	kop
korte	kort
koste	kost
kosten	kost
koude	koud
kouwe	koud
kunst-	kunst
kurken	kurk
laatst	laat
laatste	laat
land	land
lands	land
lange	lang
lapje	lap
laste	last
leste	lest
lijve	lijf
loopje	loop
losse	los
machte	macht
male	maal
meer	veel
minne	min
minste	weinig
monde	mond
n.a.converteerbare	n.a.converteerbaar
nadele	nadeel
name	naam
ogen	ooggen
onrechte	onrecht
onzekere	onzeker
oogje	oog
opzichte	opzicht
ore	oor
overvloede	overvloed
pakken	pak
paleize	paleis
perse	pers
plaatse	plaats
plekke	plek
poepje	poep
praatjes	praatje
principale	principaal
proppen	prop
rechte	recht
rollen	rol
ruste	rust
schenen	scheen
schraalhans	s
schroeven	schroef
slaatje	slaatje
slijk	slijk
sloffen	slof
slotte	slot
smiezen	smies
spandiensten	spandienst
sprake	spraak
stadhuize	stadhuis
stelligste	stellig
stelten	stelt
stoelen	stoel
straffe	straf
strijde	strijd
stuipen	stuip
tale	taale
ten	te
ter	te
tijde	tijd
tonele	toneel
treure	treur
uiltje	uil
velde	veld
verre	ver
verwachtingen	verwachting
vier	vier
vlammen	vlam
voeten	voet
voordele	voordeel
vrije	vrij
weegs	weg
wezen	wees
wijle	wijl
wille	wil
word	lemma
zake	zaak
zeerste	zeer
zeil	zeil
ziele	ziel
zielen	ziel
zijne	zijn
zijner	zijn